这|者
这里|衹块
这些|衹撮
这是|者是
这样|衹样
那些|兮些
那里|兮块
这位|衹主
这个|衹个
怎么样|乜些样
这一次|衹一次
这条|衹条
这轮|衹轮
这样做|照些做
到底是|吤是
怎么回事|做尼
同样|平样
的|介
地|介
曾|𧧸
不认识|唔𧧸
和|佮
与|佮
谈|诐
聊|诐
绳子|索
玩耍|𨑨迌
两半|二爿
说|呾
但|是呾
但是|是呾
跟着|缀
每天|每日
讲|呾
要|欲
什么时候|𠶧时
什么|乜个
以前|许𠶧时
小时候|细𠶧时
是谁|底𠶧
我们|阮
咱们|俺
自己|家己
自己人|家己人
睡|夗
粥|糜
喝粥|食糜
砂锅粥|砂锅糜
好多|好㩼
许多|好㩼
能够|有变
无法|无变
没办法|无变
没有办法|无变
没有|无
没|无
找|觅
寻找|寻觅
一些个|零个
一些|一撮
天上|天顶
回来|返来
回去|返去
小|细
缩小|缩细
他|伊
她|𡛂
它|吚
打|拍
奶奶|阿嬷
下雨|落雨
下来|落来
干净|清气
爱干净|清气相
乱说|四散呾
乱搞|四散物
乱来|四散来
有条理|四正
天气冷|天时凝
转动|纺
开荤|开臊
腥|臊
快|猛
拿|𢭪
站|徛
蹲|跍
很像|好然
半蹲|半跍徛
站直|徛直
做完|做直
累|乏
家|内
回家|返内
天亮|天光
擦|拭
不|𠀾
不难|𠀾僫
不单|唔单
不会|𠀾
不久|𠀾久
一点|滴囝
小不点|滴囝奶
差点|险险
差一点|绌滴囝
像|然
一起|做一下,做倵
水边|水墘
路边|路墘
溪边|溪墘
海边|海墘
边|畔
旁|畔
旁边|旁边
乱|荋
晕|眩
很|好%过
太|过
显赫|叻
多少|若㩼
多久|若久
全都|拢总
都|拢
都是|拢是%尽是
乖|𠢕
夸奖|哦啰
躲|坫%沕
最|尚
赌博|跋钱
跌倒|跋落
掉下|跤落
掉落|跤落
下去|落去
相识|相察
帮忙|相辅
自以为是|𠿬做是
自以为|𠿬做
怼|詏
争论|斗詏
那么|𠯋
那么1|𠀒
追|趭
拉|𠡒
吐痰|啡涎
流口水|流涎
口水|喙涎
切菜|截菜
提手旁|挑手畔
瘦|㾪
瘦猴|㾪猴
瘦骨嶙峋|㾪髂㾪髂
仔细看|䀛
喝|噜
喝水|食水
肚子饿|肚枵%肚困
铁锹|沙挑
铲子|沙挑
鸡毛掸子|鸡毛筅
大家|大家人
他们|伊人
们|伙
中午|日昼
早上|眠起早
上午|眠早
明天|明日
明早|明眠早
今天|今日
今晚|今夜
晚上|暝囝
夫妻|翁姐
小姐|小姐
后面|后畔
背后|后畔
屋子|厝
攒钱|积钱
蘸|揾
剪掉|铰掉
剪头发|铰毛
剪刀|铰刀
差得远|铰螺
更多|愈更㩼
越来越|愈来愈
越来越多|愈来愈㩼
突然|骤然
玩手机|蔑手机%耍手机
厕所|东司
粪坑|东司空
屁股|尻仓
难|僫
够了|𤰉了
够用|𤰉用
田里|垟中
几层楼|几沿楼
跨过去|伐过去
垃圾|㘰粪
不少|𠀾少
不好|孬
不错|𠀾孬
莫|孬
地上|塗下%塗骹
车轮|车辇
瞪|盺
年轻人|后生囝
给面子|畀面
很硬|好𠕇
回南天|风淫
湿漉漉|㴷㴷
装死|诈死
松动|振动
嚼烂|哺糜
咀嚼|哺
嚼|哺
手提箱|咭哔
哪个|底个
哪里|底块
等一下|加下
头一回|头下
下午|下旰
矮小|矮细
矮子|矮囝
光头|光卵
很亮|好光
一口气|一气头
斗笠|葵笠
剃须刀|剴须刀
一块田|一丘田
听天由命|听兴衰
球拍|球板
孑孓|蛆
口腔溃疡|生蛆
掉皮|爆皮
浪费|哒浪
留下来|留落来
麻风病|癞瘑
骗子|漏囝
给力|够力
蝴蝶|尾翼
一对翅膀|片翼
被人|分人
被车|分车
被|分
从小|从细
给他|分伊
日光灯|电管
抛网打鱼|抛鱼
模子|模
荸荠|荸葱
扫墓|挂纸
玩土|蔑塗
玩沙子|蔑沙
戴眼镜|挂目镜
戴手套|挂手套
头屑|头麸
脊背|尻脊
后背|尻脊枋
猜|约
近十人|成十人
行不行|𫩯好
能不能|𫩯好
人高马大|天峗人大
水蛭|胡蜞
泥鳅|胡鰡
苍蝇|胡蝇
长红疱|浮瘤
长红疱|生瘤
吸烟|吸薰
尿壶|地缸
生意|生理
臭腥|臭臊
牲畜|众牲
睾丸|朖核
屎壳郎|牛屎核
搪瓷|淋搪
是否同意|𫩯好
不同意|唔好
倒过来|反过来
很强|好强
掉链子|漂链
它的翅膀|伊片翼
固执|韧过藤
垫脚|裹脚
垫高|裹峗
垫桌脚|裹床脚
上来|起来
上去|落去
两头锋利|双头利
太锋利|过利
刚好|拄拄
刚刚好|拄拄好
碰上|拄着
凑合|粗拄
不碰巧|唔拄好
受不了|拄唔缀
呛喉咙|错喉
打喷嚏|拍咳嚏
却|哩
蹭|秽刷
却在|哩啰
正在|正啰
赶紧|猛猛
瓶子|个筒
难道|𠀾成
要是|喏是
如果|喏是
相碰|相拄
不怕|免惊
别担心|{不畏}
长得像|生来然
不能|孬
不可以|孬
或是|阿是
只想|只欲
低|𬽥
矮|𬽥
高|峗
这类|衹类
也可|也好
不给|嫑乞
东西|物件
称|呾
偷窃|偷占%偷𢭪
里边|内畔
抓到|掠着
抓住|掠着
小偷|老贼
笔记本|笔记簿
每一天|每一日
写得|写到
走|行
走路|行路
走错路|行错路
走来走去|行来行去
走近路|行近路
整个|够个
连那|连嘢
不敢|唔敢
看到|看着
桥上|桥顶
有位|有主
年轻|后生
女子|姿娘
跳下去|跳落去
仅|清
只用了|清用了
多钟|外钟
多钟|外钟
河对面|溪对面
抓鱼|掠鱼
这不是|者谜
不是|唔谜
接到|接着
两位|两主
扔|捔
对这|对衹
多岁|外岁
多|㩼
很多|好㩼
学坏|学孬
得|着
该|着
不曾|唔𧧸
长歪|生歪
赶快|猛猛
拔掉|挽掉
骗人|诓人
男子|打埠
男孩|打埠仔
女孩|姿娘仔
贪玩|好耍 
偷偷|暗静
不料|做知
身上|身顶
花光|使白
丢失|跤落去
不慎|唔知预
联系不到|联系唔着
家里人|家内人
回去家|返去内
带|扱
帮助|相辅
想要|想欲
今晚|今夜
明晚|明夜
孩子|孥仔
更要|更欲
一个多|个外
这段|衹段
开店|开铺
两天|两日
这两天|衹两日
吃一口|食一嘴
吃|食
睡|睡
套|𠕄
套走|𠕄走
套住|𠕄紧
一棵|一丛
下巴|下颏
脖子|颔
砸中|𡊵着
砸|𡊵
砸伤|𡊵伤
比拼|比拚
拼命|拚命
拼搏|拚搏
拼生死|拚生死
才过去|正过去
还应|还着
拍张照|熇张相
照相|熇相
照相机|熇相机
摔倒|跋落去
弄到最后|物到徼迈
去年|旧年
不同|唔同
最近|衹转
趁人不注意|绌人无预
趁她不注意|绌𡛂无预
趁他不注意|绌伊无预
拦车|闸车
这两个|衹两个
海浪|海涌
下水|落水
一辆|一只
动弹|振动
卡住|搹到
土路|塗路
时雨时晴|下雨下晴